............H............
.......*.===H===.*.......
......===...H...===......
...===*.....H.....*===...
..*.........H.........*..
...........=H=...........
====H=======H=======H====
.*..H.......H.......H..*.
==..H.......H.......H..==
....H...*...H...*...H....
....========H========....
...*........H........*...
............H............
..=========.H.=========..
...........RHB...........
.....*.*.*.=H=.*.*.*.....
0
